^^^^^^^^^-------------------~~~~~~~~~~~~~~~~-------------
^^^^^^^--------------------~~~~~~~~~~~~~~~~~~~~----------
^^^^^^^^^^--------------~~~~~~~~~~~~~~~~~~~~~~~----------
^^^-----------------------~~~~~~~~~~~~~~~~~~~~~~---------
^^^^---------------------~~~~~~~~~~~~~~~~~~~~~~~~~~------
^^--------------------------~~~~~~~~~~~~~~~~~~~~~--------
^--------------------------------~~~~~~~~~~~~~~----------
------------------------------------~~~~~~~~~~-----------
--------------------------------------~~~~~~~------------
---------------------------------------------------------
---------------------------------------------------------
---------------------------------------------------------